OOOOOOOOOO
O        O
O        O
O        O
O #   #  O
O  # #   O
O   #    O
O        O
O        O
OOOOOOOOOO
